Add Share=Добавить ресурс
All files encrypted=Все файлы зашифрованы
All files protected=Все файлы защищены
All files unprotected=Все файлы не защищены
Allocation method=Метод размещения
Array must be Started to view Shares=Массив должен быть **запущен** для просмотра общих ресурсов
Automatically split any directory as required=Автоматически разделять любой каталог по мере необходимости
Automatically split only the top five directory levels as required=Автоматически разделять только пять верхних уровней каталогов по мере необходимости
Automatically split only the top four directory levels as required=Автоматически разделять только четыре верхних уровня каталогов по мере необходимости
Automatically split only the top level directory as required=Автоматически разделять только каталог верхнего уровня по мере необходимости
Automatically split only the top three directory levels as required=Автоматически разделять только три верхних уровня каталогов по мере необходимости
Automatically split only the top two directory levels as required=Автоматически разделять только два верхних уровня каталогов по мере необходимости
Comments=Комментарии
Compute All=Вычислить все
Compute=Вычислить
Disk Shares=Общие ресурсы диска
Do not use reserved names=Не используйте зарезервированные имена
Do not use pool names=Не используйте имена пулов
Enable Copy-on-write=Включить копирование при записи
Enter a name for the share=Введите имя общего ресурса
Excluded disks=Исключенный диск(и)
Export=Экспорт
Fill-up=Заполнение
Free=Свободно
has been deleted=был удален
HDD=HDD
High-water=Высокий уровень
Included disks=Включенный диск(и)
Invalid Characters=Недопустимые символы
Invalid share name=Недопустимое имя общего ресурса
Manual do not automatically split directories=Вручную: не разделять каталоги автоматически
Minimum free space=Минимум свободного места
Missing share name=Отсутствует имя общего ресурса
Most-free=Наиболее свободный
Mover takes no action=Транспортировщик не предпринимает никаких действий
Mover transfers files from array to cache=Транспортировщик переносит файлы из массива в кеш
Mover transfers files from cache to array=Транспортировщик переносит файлы из кеша в массив
next user share=следующий общий ресурс пользователя
Only=Исключительно
Prefer=Предпочтительно
previous user share=предыдущий общий ресурс пользователя
Read=Прочитать
Recompute=Пересчитать
Rule=Правило
Select cache pool=Выберите пул кеша
Set when adding new share only=Устанавливается только при добавлении нового общего ресурса
Share contains data=Общий ресурс содержит данные
Share is empty=Общий ресурс пуст
Share is outside the list of designated disks=Общий ресурс находится за пределами списка назначенных дисков
Share Settings=Настройки общего ресурса
Share status=Статус общего ресурса
Size=Размер
Some or all files unencrypted=Некоторые или все файлы не зашифрованы
Some or all files unprotected=Некоторые или все файлы не защищены
Split level=Уровень разделения
SSD=SSD
There are no exportable disk shares=Нет экспортируемых общих ресурсов диска
There are no exportable user shares=Нет экспортируемых общих ресурсов пользователя
Time Machine volume size limit=Ограничение на размер тома машины времени
Unknown encryption state=Неизвестное состояние шифрования
Use cache pool for new filesdirectories=Использование пула кеша (для новых файлов/каталогов)
User Shares=Общие ресурсы пользователя
Write=Записать
You cannot use the following within share names=Вы не можете использовать эти символы в именах общих ресурсов

; Note: June 6, 2022 - 58 missing translations